4 2 8 0 5
2 7 9 4 0
2 0 1 9 1
2 7 8 3 4
3 1 0 8 5
8 5 4 2 3
8 1 3 0 8
3 2 1 6 6
6 2 6 6 4
0 0 6 2 3
5 3 7 2 2
3 4 8 3 6
7 0 6 9 3
8 4 0 9 4
7 2 8 2 2
7 3 3 8 6
3 1 4 1 2
8 5 6 8 0
5 3 8 0 2
4 5 1 7 6
